XXXXXXXXXXXXXXXXXXXXXXXXXXXXXXXXXXXXXXXXXXXXXX
111128cX111222335777777777777722222222211111X1
XXX1122569bXXXXXXXXXXXXXXXXX333333344444777771
1111244dXXXX1111111111111111111111111111111111
X3332XXXXXXXXXXXXXXXXXXXXXXXXXXXXXXXXXXXXXXXX1
XXXXXXaXXXXXXXXXXXXXXXXXXXXXXXXXXXXXXXX1122221
1111111112222444444444444455555555552222229991
1111111222234343434343422222222222227777777771
1111111111111112222222222222222233333333333331
1111111111111111111111122222222222222222333331
1111111111111111111111111111111111111111111111
XXXXXXXXXXXXXXXXXXXXXXXXXXXXXXXXXXXXXXXXXXXXXX
