XXXXXXXXXXXXXXXXXXXXXX
X32123212111123211112X
X22a22221111122211b21X
X123223211111111X1111X
XXXXXXXXXX11XXXXX12XXX
X121111211111111X1233X
X111121111111111X2XX2X
X22212111XXXXXXXX1211X
X2321211X222X111X1XXXX
X2221112X2e2X1d2X22c2X
X1111121X222X223X3233X
XXXXXXXXXXXXXXXXXXXXXX

No path possible!